14,14,14,14,14,14,0,0,0,0,0,0,0,0,0,0,0,0,0,0,2,2,0,0,0,0,0,0,0,0,0,0,0,0,0,0,0,0,2,2,2,2,2,2,2,2,26,26,26,26,26,26,26,26,26,26,26,26,26,26,26,26,26,26
14,14,14,14,14,14,0,0,0,0,0,0,0,0,0,0,0,0,0,0,2,2,0,0,0,0,0,0,0,0,0,0,0,0,0,0,0,0,2,2,2,2,2,2,2,26,26,26,26,26,26,26,26,26,26,26,26,26,26,26,26,26,26,26
14,14,14,14,14,14,0,0,0,14,14,14,14,14,14,0,0,0,0,0,2,2,0,0,0,0,0,0,0,0,0,0,0,0,0,0,0,0,2,2,2,2,2,2,2,26,26,26,26,26,26,26,26,26,26,26,26,26,26,26,26,26,26,26
14,14,14,14,14,14,14,0,0,14,14,14,14,14,14,0,0,0,0,0,2,2,0,0,0,0,0,0,0,0,0,0,0,0,0,0,0,0,0,2,2,2,2,2,2,26,26,26,26,26,26,26,26,26,26,26,26,26,26,26,26,26,26,26
14,14,14,14,14,14,14,0,0,14,14,14,14,14,14,0,0,0,0,0,2,2,2,2,0,0,0,0,0,0,0,0,0,0,0,0,0,0,0,2,2,2,2,2,2,26,26,26,26,26,26,26,26,26,26,26,26,26,26,26,26,26,26,26
14,14,14,14,14,14,14,0,0,14,14,14,14,14,14,0,0,0,0,0,2,2,2,2,0,0,0,0,0,0,0,0,0,0,0,0,0,0,0,0,0,0,2,2,2,2,26,26,26,26,26,26,26,26,26,26,26,26,26,26,26,26,26,26
14,14,14,14,14,14,14,0,0,14,14,14,14,14,14,0,0,0,0,0,2,2,2,2,0,0,0,0,0,0,0,0,0,0,0,0,0,0,0,0,0,0,2,2,2,2,26,26,26,26,26,26,26,26,26,26,26,26,26,26,26,26,26,26
14,14,14,14,14,14,14,0,0,14,14,14,14,14,14,0,0,0,0,0,0,2,2,2,0,0,0,0,0,0,0,0,0,0,0,0,0,0,0,0,0,0,0,0,0,0,26,26,26,26,26,26,26,26,26,26,26,26,26,26,26,26,26,26
14,14,14,14,14,14,14,0,0,0,0,0,0,0,0,0,0,0,0,0,0,0,2,2,0,0,0,0,0,0,0,0,0,0,0,0,0,0,0,0,0,0,0,0,0,0,0,26,26,26,26,26,26,26,26,26,26,26,26,26,26,26,26,26
14,14,14,14,14,14,14,0,0,0,0,0,0,0,0,0,0,0,0,14,14,0,0,0,0,0,0,0,0,0,0,0,0,0,0,0,0,0,0,0,0,0,0,0,0,0,0,26,26,26,26,26,26,26,26,26,26,26,26,26,26,26,26,26
14,14,14,14,14,14,14,0,0,0,0,0,0,0,0,0,0,0,0,14,14,0,0,0,0,0,0,0,2,2,2,0,0,0,0,0,0,0,0,0,0,0,0,0,0,0,0,26,26,26,26,26,26,26,26,26,26,26,26,26,26,26,26,26
0,0,0,0,0,0,0,0,0,0,0,0,0,0,0,0,0,14,14,14,0,0,0,0,0,0,0,0,2,2,2,0,0,0,0,0,0,0,0,0,0,0,0,0,0,0,0,26,26,26,26,26,26,26,26,26,26,26,26,26,26,26,26,26
0,0,0,0,0,0,0,0,0,0,0,0,0,0,0,0,0,14,14,14,0,0,0,0,0,0,0,0,2,2,2,0,0,0,0,0,0,0,0,0,0,0,0,0,0,0,0,26,26,26,26,26,26,26,26,26,26,26,26,26,26,26,26,26
0,0,0,0,0,0,0,0,0,0,0,0,0,0,0,0,0,0,14,0,0,0,0,0,0,0,0,0,0,0,0,0,0,0,0,0,0,0,0,0,0,0,0,0,0,0,0,26,26,26,26,26,26,26,26,26,26,26,26,26,26,26,26,26
0,0,0,0,0,0,0,0,0,0,0,0,0,0,0,0,0,0,14,0,0,0,0,0,14,14,0,0,0,0,0,0,0,0,0,0,0,0,0,0,0,0,0,0,0,0,0,26,26,26,26,26,26,26,26,26,26,26,26,26,26,26,26,26
0,0,0,0,0,0,0,0,0,0,0,0,0,0,0,0,0,0,0,0,0,0,0,0,14,14,0,0,0,0,0,0,0,0,0,0,0,0,0,0,0,0,0,0,0,0,0,26,26,26,26,26,26,26,26,26,26,26,26,26,26,26,26,26
0,0,0,0,0,0,0,0,0,0,0,0,0,0,0,0,0,0,0,0,0,0,0,0,0,0,0,0,0,0,0,0,0,0,0,0,0,0,0,0,0,0,0,0,0,0,0,26,26,26,26,26,26,26,26,26,26,26,26,26,26,26,26,26
0,0,0,0,0,0,0,0,0,0,0,0,0,0,0,0,0,0,0,0,0,0,0,0,0,0,0,0,0,0,0,0,0,14,14,14,14,0,0,0,0,0,0,0,0,0,0,26,26,26,26,26,26,26,26,26,26,26,26,26,26,26,26,26
0,0,0,0,0,0,0,0,0,0,0,0,0,0,0,0,0,0,0,0,0,2,0,0,0,0,0,0,0,0,0,0,0,14,14,14,14,0,0,0,0,0,0,0,0,0,0,26,26,26,26,26,26,26,26,26,26,26,26,26,26,26,26,26
0,0,0,0,0,0,0,0,0,0,0,0,0,0,0,0,0,0,0,0,0,2,2,2,2,0,0,0,0,0,0,0,0,14,14,14,14,0,0,0,0,0,0,0,0,0,0,0,26,26,26,26,26,26,26,26,26,26,26,26,26,26,26,26
0,0,0,0,0,0,0,0,0,0,0,0,0,0,0,0,0,0,2,2,0,2,2,2,2,0,0,0,0,0,0,0,0,14,14,14,14,0,0,0,0,0,0,0,0,0,0,0,26,26,26,26,26,26,26,26,26,26,26,26,26,26,26,26
0,0,0,0,0,0,0,0,0,0,0,0,0,0,0,0,0,0,2,2,0,0,2,2,2,0,0,0,0,0,0,0,0,14,14,14,14,0,0,0,0,0,0,0,0,2,2,2,2,2,26,26,26,26,26,26,26,26,26,26,26,26,26,26
14,14,0,0,0,0,0,0,0,0,0,0,0,0,0,0,0,0,2,2,0,0,0,0,0,0,0,0,0,0,0,0,0,0,14,14,14,14,14,14,14,0,0,0,0,2,2,2,2,2,26,26,26,26,26,26,26,26,26,26,26,26,26,26
14,14,0,0,0,0,0,0,0,0,0,0,0,0,0,0,0,0,0,0,0,0,0,0,0,0,0,0,2,2,2,2,0,0,14,14,14,14,14,14,14,0,0,0,0,2,2,2,2,2,26,26,26,26,26,26,26,26,26,26,26,26,26,26
14,14,0,0,0,0,0,0,0,0,0,0,0,0,0,0,0,0,0,0,0,0,0,0,0,2,2,2,2,2,2,2,2,2,14,14,14,14,14,14,14,0,0,2,2,2,2,2,2,26,26,26,26,26,26,26,26,26,26,26,26,26,26,26
14,14,0,0,0,0,0,0,0,0,0,0,0,0,0,0,0,0,0,0,0,0,0,0,0,2,2,2,2,2,2,2,2,2,14,14,14,14,14,14,14,0,0,2,2,2,2,2,2,26,26,26,26,26,26,26,26,26,26,26,26,26,26,26
14,14,14,14,14,0,0,0,0,0,0,14,14,14,0,0,14,14,14,14,14,14,0,0,0,2,2,2,2,2,2,2,2,2,2,2,0,0,0,0,0,0,0,2,2,2,2,2,2,26,26,26,26,26,26,26,26,26,26,26,26,26,26,26
14,14,14,14,14,0,0,0,0,0,0,14,14,14,0,0,14,14,14,14,14,14,0,0,2,2,2,2,2,2,2,2,2,2,2,0,0,0,0,0,0,0,0,2,2,2,2,2,2,26,26,26,26,26,26,26,26,26,26,26,26,26,26,26
14,14,14,14,14,14,0,0,0,0,0,14,14,14,14,14,14,14,14,14,14,14,0,0,2,2,2,2,2,2,2,2,2,2,0,0,0,0,0,0,0,0,0,2,2,2,2,2,2,26,26,26,26,26,26,26,26,26,26,26,26,26,26,26
14,14,14,14,14,14,0,0,0,0,0,0,0,14,14,14,14,14,14,14,14,14,0,0,2,2,2,2,2,2,2,2,2,2,0,0,0,0,0,14,14,14,0,2,2,2,2,2,2,26,26,26,26,26,26,26,26,26,26,26,26,26,26,26
14,14,14,14,14,14,0,0,0,0,0,0,0,14,14,14,14,14,14,14,14,14,0,0,2,2,2,2,2,2,2,2,2,2,0,0,0,14,14,14,14,14,0,2,2,2,2,2,26,26,26,26,26,26,26,26,26,26,26,26,26,26,26,26
14,14,14,14,14,2,2,2,2,2,0,0,0,14,14,14,14,14,14,14,14,14,0,0,2,2,2,2,2,2,2,2,2,0,0,0,0,14,14,14,14,14,0,2,2,2,2,2,26,26,26,26,26,26,26,26,26,26,26,26,26,26,26,26
14,14,14,14,14,2,2,2,2,2,0,0,0,14,14,14,14,14,14,14,14,14,0,0,2,2,2,2,2,2,2,2,2,0,0,0,0,14,14,14,14,0,0,2,2,2,2,2,26,26,26,26,26,26,26,26,26,26,26,26,26,26,26,26
14,14,2,2,2,2,2,2,2,2,0,0,0,14,14,14,14,14,14,14,14,14,0,0,2,2,2,2,2,2,2,2,2,0,0,0,0,14,14,14,14,0,0,2,2,2,2,2,26,26,26,26,26,26,26,26,26,26,26,26,26,26,26,26
14,14,2,2,2,2,2,0,0,0,0,0,0,0,0,14,14,14,14,14,14,14,0,0,0,0,0,2,2,2,2,2,2,2,2,0,0,14,14,14,14,0,0,2,2,2,2,2,26,26,26,26,26,26,26,26,26,26,26,26,26,26,26,26
2,2,2,2,2,2,2,0,0,0,0,0,0,0,0,14,14,14,14,14,14,14,0,0,0,0,0,2,2,2,2,2,2,2,2,0,0,14,14,14,14,0,0,2,2,2,2,2,26,26,26,26,26,26,26,26,26,26,26,26,26,26,26,26
,,,,,,,,,,,,,,,,,,,,,,,,,,,,,,,,,,,,,,,,,,,,,,,,,,,,,,,,,,,,,,,
,,,,,,,,,,,,,,,,,,,,,,,,,,,,,,,,,,,,,,,,,,,,,,,,,,,,,,,,,,,,,,,
,,,,,,,,,,,,,,,,,,,,,,,,,,,,,,,,,,,,,,,,,,,,,,,,,,,,,,,,,,,,,,,
,,,,,,,,,,,,,,,,,,,,,,,,,,,,,,,,,,,,,,,,,,,,,,,,,,,,,,,,,,,,,,,
,,,,,,,,,,,,,,,,,,,,,,,,,,,,,,,,,,,,,,,,,,,,,,,,,,,,,,,,,,,,,,,
,,,,,,,,,,,,,,,,,,,,,,,,,,,,,,,,,,,,,,,,,,,,,,,,,,,,,,,,,,,,,,,
,,,,,,,,,,,,,,,,,,,,,,,,,,,,,,,,,,,,,,,,,,,,,,,,,,,,,,,,,,,,,,,
